NO ./textures/north.xpm
SO ./textures/south.xpm
WE ./textures/west.xpm
EA ./textures/east.xpm

111111111111111
100000000000001
100000000000001
100000100000001
100000000000001
100000010000001
100001000000001
100001000000001
100001000000001
100001000000001
100001000000001
100001000000001
100001000000001
100001000000001
100001000000001
111111111111111
