NO ./textures/north.xpm
SO ./textures/south.xpm
WE ./textures/west.xpm
EA ./textures/east.xpm
F 150,75,0
C 0,0,0

1111111111111111
1000000000000001
1000000000000001
1000000000000001
1000000000000001
1000001000000001
1000000000000001
1000000100000001
10000100000000011111
1111111111111111
