NO ./textures/north.xpm
SO ./textures/south.xpm
WE ./textures/west.xpm
EA ./textures/east.xpm
F 220,100,0
C 225,30,0

111111111111111
1000000000000S1
100000000000001
100000100000
100000010000001
100001000000001
 11111111111111
