NO ./textures/north.xpm
SO ./textures/south.xpm
WE ./textures/west.xpm
EA ./textures/east.xpm
F 150,75,0
C 0,0,0

        1111111111111111111111111
        1001000000000000000E00001
111111111011000001110000000000001
100000000011000001110111111111111
11110111111111011100000010001
11110111111111011101010010001
11000000110101011100000010101
10000000000000001100000010101
10000000000000001101010010101
11111111111111111111111111111
