NO ./textures/north.xpm
SO ./textures/south.xpm
WE ./textures/west.xpm
EA ./textures/east.xpm
F 150,75,0
C 0,0,0

   11111111
  1000000001
 100000000001
10000000000001
10000000000001
 10000000000001
  100000E00001
   1111111111
