NO ./textures/north.xpm
SO ./textures/south.xpm
WE ./textures/west.xpm
EA ./textures/east.xpm
F 150,75,0
C 0,0,0

111111111111111
1000000000000S1
100000000000001
100000000000001
100000000000001
100000000000001
100000100000001
100000000000011111111
100000010000001
100001000000001
 11111111111111
